111111111111111111111111111111111111111111111
10A000000000000000100000000100000000000000001
11110000000000000010000K000100000000000000001
100000000000000000100000000100000000000000001
100000000000000000100000000100000000000000001
100000000000000000100000000100000000000000001
100000001110000000100000000100000001110000001
100000000000000000100000000100000000000000001
100000000000000000100000000100000000000000001
100000011111110000100000000100000000000000001
100000000000000000100000000100000000000000001
100000000000000000100000000111111000000000001
111111000000000000100000000100000000000000001
100000000000000000100000000100000000000000001
100000000000000000100000000100000000000000001
1000000010000000001000000001000000000000B0001
100000000000000000100000000100000000000000001
111111111111111111111111111111111111111111111
