11111111111111111111111111111111111111111111
10A00000000000000010000000100000000000000001
1111000000000000001000C000100000000000000001
10000000000000000010001000100000000000000001
1000000000000000001SSSSSSS100000000000000001
10000000111000000010000000100000001110000001
10000000000000000010000000100000000000000001
10000000000000000010000000111111000000000001
10000000000000000010000000100000000000000001
10000000000000000410000000100000000000000031
100000000000100111100000001000000000000B0111
1200000000000011111WWWWWWW160001000000011111
11111111111111111111111111111111111111111111
