11111111111111111111111111111111111111111111
10A00000000000000010000000100000000000000001
1111000000000000001000C000100000000000000001
10000000000000000010001000100000000000000001
10000000000000000010000000100000000000000001
10000000000000000010000000100000000000000001
10000000111000000010000000100000001110000001
10000000000000000010000000100000000000000001
10000000000000000010000000100000000000000001
10000001111111000010000000100000000000000001
10000000000000000010000000100000000000000001
10000000000000000010000000111111000000000001
11111100000000000010000000100000000000000001
10000000000000000010000000100000000000000001
10000000000000000010000000100000000000000001
100000001000100111100000001000000000000B0001
10000000000000111110000000100000000000000001
11111111111111111111111111111111111111111111
